//MAP CONVERTED BY dmm2tgm.py THIS HEADER COMMENT PREVENTS RECONVERSION, DO NOT REMOVE
"aa" = (
/turf/simulated/ocean,
/area/space/ocean)
"ab" = (
/turf/simulated/wall/constructed/r_wall,
/area/cassini)
"ac" = (
/obj/effect/wingrille_spawn/reinforced/full,
/turf/simulated/floor/plating,
/area/cassini)
"ad" = (
/turf/simulated/floor/tiled,
/area/cassini)
"ae" = (
/obj/effect/wingrille_spawn/reinforced_phoron/full,
/turf/simulated/floor/plating,
/area/cassini)
"af" = (
/turf/simulated/floor/tiled/dark,
/area/cassini)
"ag" = (
/obj/effect/landmark{
	name = "JoinLate"
	},
/turf/simulated/floor/tiled,
/area/cassini)
"ah" = (
/turf/simulated/floor/tiled/dark/monotile,
/area/cassini)
"ai" = (
/turf/simulated/floor/tiled/steel_grid,
/area/cassini)
"aj" = (
/turf/simulated/wall/constructed,
/area/cassini)
"ak" = (
/turf/simulated/floor/tiled/steel_ridged,
/area/cassini)
"al" = (
/turf/simulated/floor/tiled/monotile,
/area/cassini)
"am" = (
/turf/simulated/floor/tiled/techmaint,
/area/cassini)
"an" = (
/turf/simulated/floor/reinforced/airless,
/area/cassini)
"ao" = (
/obj/effect/landmark{
	name = "JoinLate"
	},
/turf/simulated/floor/tiled/dark,
/area/cassini)
"ap" = (
/obj/effect/landmark{
	name = "JoinLate"
	},
/turf/simulated/floor/tiled/steel_grid,
/area/cassini)
"aq" = (
/obj/effect/landmark/test/safe_turf,
/turf/simulated/floor/tiled/steel_grid,
/area/cassini)
"ar" = (
/obj/effect/landmark/start,
/turf/simulated/floor/tiled/dark,
/area/cassini)
"as" = (
/obj/effect/floor_decal/corner/lime{
	icon_state = "corner_white";
	dir = 1
	},
/obj/effect/floor_decal/corner/green{
	icon_state = "corner_white";
	dir = 4
	},
/obj/effect/floor_decal/corner/green{
	icon_state = "corner_white";
	dir = 8
	},
/turf/simulated/floor/tiled/monotile,
/area/cassini)
"at" = (
/obj/effect/floor_decal/corner/lime{
	icon_state = "corner_white";
	dir = 1
	},
/obj/effect/floor_decal/corner/green{
	icon_state = "corner_white";
	dir = 4
	},
/turf/simulated/floor/tiled/monotile,
/area/cassini)
"au" = (
/obj/structure/cable{
	icon_state = "0-8"
	},
/obj/machinery/power/apc/high{
	pixel_y = -24
	},
/turf/simulated/floor/tiled/techmaint,
/area/cassini)
"av" = (
/obj/effect/floor_decal/corner/lime,
/obj/effect/floor_decal/corner/lime{
	icon_state = "corner_white";
	dir = 1
	},
/obj/effect/floor_decal/corner/green{
	icon_state = "corner_white";
	dir = 4
	},
/turf/simulated/floor/tiled/monotile,
/area/cassini)
"aw" = (
/obj/machinery/light{
	icon_state = "tube_map";
	dir = 8
	},
/turf/simulated/floor/tiled/dark,
/area/cassini)
"ax" = (
/obj/machinery/atmospherics/portables_connector,
/obj/machinery/portable_atmospherics/canister/air,
/obj/effect/floor_decal/corner/lime{
	icon_state = "corner_white";
	dir = 1
	},
/obj/effect/floor_decal/corner/green{
	icon_state = "corner_white";
	dir = 8
	},
/turf/simulated/floor/tiled/steel_ridged,
/area/cassini)
"ay" = (
/obj/machinery/power/debug_items/infinite_generator,
/obj/structure/cable,
/turf/simulated/floor/reinforced/airless,
/area/cassini)
"az" = (
/turf/simulated/floor/tiled/white,
/area/cassini)
"aA" = (
/turf/simulated/floor/tiled/white/monotile,
/area/cassini)
"aB" = (
/obj/structure/table/standard,
/obj/effect/floor_decal/corner/paleblue/three_quarters{
	icon_state = "corner_white_three_quarters";
	dir = 8
	},
/turf/simulated/floor/tiled/white,
/area/cassini)
"aC" = (
/obj/structure/table/standard,
/obj/machinery/photocopier,
/obj/effect/floor_decal/corner/paleblue{
	icon_state = "corner_white";
	dir = 5
	},
/turf/simulated/floor/tiled/white,
/area/cassini)
"aD" = (
/obj/machinery/light{
	icon_state = "tube_map";
	dir = 1
	},
/obj/machinery/computer/atmos_alert,
/obj/effect/floor_decal/corner/paleblue{
	icon_state = "corner_white";
	dir = 5
	},
/turf/simulated/floor/tiled/white,
/area/cassini)
"aE" = (
/obj/machinery/atmospherics/portables_connector,
/obj/machinery/portable_atmospherics/canister/empty,
/obj/effect/floor_decal/corner/lime,
/obj/effect/floor_decal/corner/green{
	icon_state = "corner_white";
	dir = 4
	},
/turf/simulated/floor/tiled/steel_ridged,
/area/cassini)
"aF" = (
/obj/structure/table/marble,
/turf/simulated/floor/lino,
/area/cassini)
"aG" = (
/obj/machinery/atmospherics/pipe/simple/hidden/blue,
/obj/effect/floor_decal/corner/lime{
	icon_state = "corner_white";
	dir = 1
	},
/obj/effect/floor_decal/corner/green{
	icon_state = "corner_white";
	dir = 8
	},
/turf/simulated/floor/tiled/steel_grid,
/area/cassini)
"aH" = (
/obj/effect/landmark/test/space_turf,
/turf/simulated/ocean,
/area/space/ocean)
"aI" = (
/obj/machinery/atmospherics/pipe/simple/hidden/red,
/obj/effect/floor_decal/corner/lime,
/obj/effect/floor_decal/corner/green{
	icon_state = "corner_white";
	dir = 4
	},
/turf/simulated/floor/tiled/steel_grid,
/area/cassini)
"aJ" = (
/obj/machinery/light{
	icon_state = "tube_map";
	dir = 4
	},
/turf/simulated/floor/tiled/techmaint,
/area/cassini)
"aK" = (
/turf/simulated/floor/lino,
/area/cassini)
"aL" = (
/obj/machinery/light{
	icon_state = "tube_map";
	dir = 1
	},
/turf/simulated/floor/tiled/dark,
/area/cassini)
"aM" = (
/obj/structure/cable{
	icon_state = "1-2"
	},
/turf/simulated/floor/reinforced/airless,
/area/cassini)
"aN" = (
/obj/structure/table/woodentable,
/turf/simulated/floor/wood,
/area/cassini)
"aO" = (
/obj/structure/cable{
	icon_state = "4-8"
	},
/turf/simulated/floor/tiled/techmaint,
/area/cassini)
"aP" = (
/turf/simulated/floor/wood,
/area/cassini)
"aQ" = (
/obj/machinery/alarm{
	pixel_y = 12
	},
/turf/simulated/floor/tiled/dark,
/area/cassini)
"aR" = (
/obj/machinery/light{
	icon_state = "tube_map";
	dir = 4
	},
/turf/simulated/floor/tiled/dark,
/area/cassini)
"aS" = (
/obj/machinery/atmospherics/pipe/simple/visible/universal,
/obj/effect/floor_decal/corner/lime{
	icon_state = "corner_white";
	dir = 1
	},
/obj/effect/floor_decal/corner/green{
	icon_state = "corner_white";
	dir = 8
	},
/turf/simulated/floor/tiled,
/area/cassini)
"aT" = (
/obj/structure/bed/chair/comfy/black{
	icon_state = "comfychair_preview";
	dir = 8
	},
/turf/simulated/floor/wood,
/area/cassini)
"aU" = (
/obj/structure/bed/chair/comfy/black{
	icon_state = "comfychair_preview";
	dir = 4
	},
/turf/simulated/floor/wood,
/area/cassini)
"aV" = (
/obj/machinery/atmospherics/pipe/simple/visible/universal,
/obj/effect/floor_decal/corner/lime,
/obj/effect/floor_decal/corner/green{
	icon_state = "corner_white";
	dir = 4
	},
/turf/simulated/floor/tiled,
/area/cassini)
"aW" = (
/obj/machinery/light{
	icon_state = "tube_map";
	dir = 8
	},
/turf/simulated/floor/tiled/techmaint,
/area/cassini)
"aX" = (
/obj/item/weapon/stool/bar/padded,
/turf/simulated/floor/wood,
/area/cassini)
"aY" = (
/obj/effect/wingrille_spawn/reinforced_phoron/full,
/obj/structure/cable{
	icon_state = "1-2"
	},
/turf/simulated/floor/plating,
/area/cassini)
"aZ" = (
/obj/machinery/light,
/turf/simulated/floor/tiled/monotile,
/area/cassini)
"ba" = (
/obj/structure/bed/chair/comfy/black,
/turf/simulated/floor/wood,
/area/cassini)
"bb" = (
/obj/structure/bed/chair/comfy/black{
	icon_state = "comfychair_preview";
	dir = 1
	},
/turf/simulated/floor/wood,
/area/cassini)
"bc" = (
/obj/machinery/light,
/turf/simulated/floor/tiled/dark,
/area/cassini)
"bd" = (
/obj/machinery/computer/crew,
/obj/effect/floor_decal/corner/paleblue{
	icon_state = "corner_white";
	dir = 5
	},
/turf/simulated/floor/tiled/white,
/area/cassini)
"be" = (
/obj/structure/table/standard,
/obj/item/weapon/reagent_containers/syringe,
/obj/effect/floor_decal/corner/paleblue/three_quarters{
	icon_state = "corner_white_three_quarters";
	dir = 1
	},
/turf/simulated/floor/tiled/white,
/area/cassini)
"bf" = (
/obj/structure/table/standard,
/obj/item/weapon/reagent_containers/spray,
/obj/effect/floor_decal/corner/paleblue{
	icon_state = "corner_white";
	dir = 9
	},
/turf/simulated/floor/tiled/white,
/area/cassini)
"bg" = (
/obj/structure/table/standard,
/obj/machinery/light{
	icon_state = "tube_map";
	dir = 4
	},
/obj/item/weapon/reagent_containers/glass/beaker,
/obj/effect/floor_decal/corner/paleblue{
	icon_state = "corner_white";
	dir = 6
	},
/turf/simulated/floor/tiled/white,
/area/cassini)
"bh" = (
/obj/machinery/light/small{
	icon_state = "bulb_map";
	dir = 1
	},
/turf/simulated/floor/wood,
/area/cassini)
"bi" = (
/obj/machinery/light/small{
	icon_state = "bulb_map";
	dir = 8
	},
/turf/simulated/floor/wood,
/area/cassini)
"bj" = (
/obj/machinery/light/small,
/turf/simulated/floor/lino,
/area/cassini)
"bk" = (
/obj/structure/table/woodentable,
/obj/machinery/light/small{
	icon_state = "bulb_map";
	dir = 4
	},
/turf/simulated/floor/wood,
/area/cassini)
"bl" = (
/obj/structure/table/marble,
/obj/machinery/chemical_dispenser/bar_soft,
/turf/simulated/floor/lino,
/area/cassini)
"bm" = (
/obj/structure/table/marble,
/obj/machinery/chemical_dispenser/bar_coffee,
/turf/simulated/floor/lino,
/area/cassini)
"bn" = (
/obj/structure/closet/secure_closet/cassini/medical,
/obj/machinery/light{
	icon_state = "tube_map";
	dir = 8
	},
/obj/effect/floor_decal/corner/paleblue{
	icon_state = "corner_white";
	dir = 9
	},
/turf/simulated/floor/tiled/white,
/area/cassini)
"bo" = (
/obj/structure/closet/secure_closet/cassini/medical,
/obj/effect/floor_decal/corner/paleblue{
	icon_state = "corner_white";
	dir = 9
	},
/turf/simulated/floor/tiled/white,
/area/cassini)
"bp" = (
/obj/structure/table/marble,
/obj/machinery/chemical_dispenser/bar_alc,
/turf/simulated/floor/lino,
/area/cassini)
"bq" = (
/obj/machinery/light/small,
/obj/machinery/microwave,
/obj/structure/table/marble,
/turf/simulated/floor/lino,
/area/cassini)
"br" = (
/obj/machinery/microwave,
/obj/structure/table/marble,
/turf/simulated/floor/lino,
/area/cassini)
"bs" = (
/obj/machinery/media/jukebox,
/turf/simulated/floor/lino,
/area/cassini)
"bt" = (
/obj/machinery/newscaster{
	pixel_x = 24
	},
/turf/simulated/floor/tiled/dark,
/area/cassini)
"bu" = (
/obj/machinery/fusion_fuel_injector/mapped,
/turf/simulated/floor/tiled/techmaint,
/area/cassini)
"bv" = (
/obj/structure/cable{
	icon_state = "2-4"
	},
/obj/machinery/fusion_fuel_injector/mapped,
/turf/simulated/floor/tiled/techmaint,
/area/cassini)
"bw" = (
/obj/structure/cable{
	icon_state = "4-8"
	},
/obj/machinery/fusion_fuel_injector/mapped,
/turf/simulated/floor/tiled/techmaint,
/area/cassini)
"bx" = (
/obj/machinery/kinetic_harvester,
/turf/simulated/floor/tiled/techmaint,
/area/cassini)
"by" = (
/obj/machinery/fusion_fuel_compressor,
/turf/simulated/floor/tiled/techmaint,
/area/cassini)
"bz" = (
/obj/machinery/botany/editor,
/turf/simulated/floor/tiled,
/area/cassini)
"bA" = (
/obj/machinery/botany/extractor,
/turf/simulated/floor/tiled,
/area/cassini)
"bB" = (
/obj/machinery/seed_storage,
/turf/simulated/floor/tiled,
/area/cassini)
"bC" = (
/obj/machinery/seed_extractor,
/turf/simulated/floor/tiled,
/area/cassini)
"bD" = (
/obj/machinery/smartfridge,
/turf/simulated/floor/tiled,
/area/cassini)
"bE" = (
/obj/structure/table/woodentable,
/obj/item/weapon/reagent_containers/food/drinks/cans/dr_gibb,
/turf/simulated/floor/wood,
/area/cassini)
"bF" = (
/obj/structure/table/marble,
/obj/item/weapon/reagent_containers/food/drinks/pitcher,
/turf/simulated/floor/lino,
/area/cassini)
"bG" = (
/obj/structure/table/marble,
/obj/item/weapon/reagent_containers/food/drinks/cans/dr_gibb,
/turf/simulated/floor/lino,
/area/cassini)
"bH" = (
/obj/structure/table/marble,
/obj/item/weapon/reagent_containers/food/drinks/shaker,
/turf/simulated/floor/lino,
/area/cassini)
"bI" = (
/obj/structure/table/marble,
/obj/item/glass_jar,
/turf/simulated/floor/lino,
/area/cassini)
"bJ" = (
/obj/effect/floor_decal/corner/paleblue{
	icon_state = "corner_white";
	dir = 6
	},
/obj/structure/filingcabinet,
/turf/simulated/floor/tiled/white,
/area/cassini)
"bK" = (
/obj/structure/closet/secure_closet/cassini/medical,
/obj/effect/floor_decal/corner/paleblue/three_quarters,
/turf/simulated/floor/tiled/white,
/area/cassini)
"bL" = (
/obj/effect/floor_decal/corner/paleblue{
	icon_state = "corner_white";
	dir = 10
	},
/turf/simulated/floor/tiled/white,
/area/cassini)
"bM" = (
/obj/structure/table/standard,
/obj/machinery/light,
/obj/machinery/reagentgrinder,
/obj/effect/floor_decal/corner/paleblue{
	icon_state = "corner_white";
	dir = 10
	},
/turf/simulated/floor/tiled/white,
/area/cassini)
"bN" = (
/obj/structure/table/standard,
/obj/machinery/chemical_dispenser,
/obj/effect/floor_decal/corner/paleblue{
	icon_state = "corner_white";
	dir = 10
	},
/turf/simulated/floor/tiled/white,
/area/cassini)
"bO" = (
/obj/structure/table/standard,
/obj/item/weapon/reagent_containers/dropper,
/obj/effect/floor_decal/corner/paleblue/three_quarters{
	icon_state = "corner_white_three_quarters";
	dir = 4
	},
/turf/simulated/floor/tiled/white,
/area/cassini)
"bP" = (
/obj/machinery/atmospherics/pipe/simple/hidden/supply,
/obj/effect/floor_decal/corner/lime{
	icon_state = "corner_white";
	dir = 1
	},
/obj/effect/floor_decal/corner/green{
	icon_state = "corner_white";
	dir = 8
	},
/turf/simulated/floor/tiled,
/area/cassini)
"bQ" = (
/obj/machinery/atmospherics/pipe/simple/hidden/scrubbers,
/obj/effect/floor_decal/corner/lime,
/obj/effect/floor_decal/corner/green{
	icon_state = "corner_white";
	dir = 4
	},
/turf/simulated/floor/tiled,
/area/cassini)
"bR" = (
/obj/machinery/atmospherics/unary/vent_pump{
	icon_state = "map_vent";
	dir = 1
	},
/obj/effect/floor_decal/corner/lime{
	icon_state = "corner_white";
	dir = 1
	},
/obj/effect/floor_decal/corner/green{
	icon_state = "corner_white";
	dir = 8
	},
/turf/simulated/floor/tiled/steel_grid,
/area/cassini)
"bS" = (
/obj/machinery/atmospherics/unary/vent_scrubber{
	icon_state = "map_scrubber_on";
	dir = 1
	},
/obj/effect/floor_decal/corner/lime,
/obj/effect/floor_decal/corner/green{
	icon_state = "corner_white";
	dir = 4
	},
/turf/simulated/floor/tiled/steel_grid,
/area/cassini)
"bT" = (
/obj/effect/floor_decal/corner/lime{
	icon_state = "corner_white";
	dir = 1
	},
/obj/effect/floor_decal/corner/lime,
/obj/effect/floor_decal/corner/green{
	icon_state = "corner_white";
	dir = 8
	},
/turf/simulated/floor/tiled/steel_ridged,
/area/cassini)
"bU" = (
/obj/effect/floor_decal/corner/lime,
/obj/effect/floor_decal/corner/green{
	icon_state = "corner_white";
	dir = 8
	},
/turf/simulated/floor/tiled/steel_ridged,
/area/cassini)
"bV" = (
/obj/effect/floor_decal/corner/lime,
/obj/effect/floor_decal/corner/green{
	icon_state = "corner_white";
	dir = 4
	},
/obj/effect/floor_decal/corner/green{
	icon_state = "corner_white";
	dir = 8
	},
/turf/simulated/floor/tiled/steel_ridged,
/area/cassini)
"bW" = (
/obj/effect/fluid_mapped,
/turf/simulated/floor/tiled,
/area/cassini)
"bX" = (
/obj/structure/drain,
/turf/simulated/floor/tiled/steel_grid,
/area/cassini)
"bY" = (
/obj/effect/fluid_mapped,
/obj/structure/hygiene/toilet,
/turf/simulated/floor/tiled,
/area/cassini)

(1,1,1) = {"
aa
aa
aa
aa
aa
aa
aa
aa
aa
aa
aa
aa
aa
aa
aa
aa
aa
aa
aa
aa
aa
aa
aa
aa
aa
aa
aa
aa
aa
aa
aa
aa
aa
aa
aa
aa
aa
aa
aa
aa
aa
aa
aa
aa
aa
aa
aa
aa
aa
aa
aa
aa
aa
aa
aa
aa
aa
aa
aa
aa
aa
aa
aa
aa
"}
(2,1,1) = {"
aa
aa
aa
aa
aa
aa
aa
aa
aa
aa
aa
aa
aa
aa
aa
aa
aa
aa
aa
aa
aa
aa
aa
aa
aa
aa
aa
aa
aa
aa
aa
aa
aa
aa
aa
aa
aa
aa
aa
aa
aa
aa
aa
aa
aa
aa
aa
aa
aa
aa
aa
aa
aa
aa
aa
aa
aa
aa
aa
aa
aa
aa
aa
aa
"}
(3,1,1) = {"
aa
aa
aa
aa
aa
aa
aa
aa
aa
aa
aa
aa
aa
aa
aa
aa
aa
aa
aa
aa
aa
aa
aa
aa
aa
aa
aa
aa
aa
aa
aa
aa
aa
aa
aa
aa
aa
aa
aa
aa
aa
aa
aa
aa
aa
aa
aa
aa
aa
aa
aa
aa
aa
aa
aa
aa
aa
aa
aa
aa
aa
aH
aa
aa
"}
(4,1,1) = {"
aa
aa
aa
aa
aa
aa
aa
aa
aa
aa
aa
aa
aa
aa
aa
aa
aa
aa
aa
aa
aa
aa
aa
aa
aa
aa
aa
aa
aa
aa
aa
aa
aa
aa
aa
aa
aa
aa
aa
aa
aa
aa
aa
aa
aa
aa
aa
aa
aa
aa
aa
aa
aa
aa
aa
aa
aa
aa
aa
aa
aa
aa
aa
aa
"}
(5,1,1) = {"
aa
aa
aa
aa
aa
aa
aa
aa
aa
aa
aa
aa
aa
aa
aa
aa
aa
aa
aa
aa
aa
aa
aa
aa
aa
aa
aa
aa
aa
aa
aa
aa
aa
aa
aa
aa
aa
aa
aa
aa
aa
aa
aa
aa
aa
aa
aa
aa
aa
aa
aa
aa
aa
aa
aa
aa
aa
aa
aa
aa
aa
aa
aa
aa
"}
(6,1,1) = {"
aa
aa
aa
aa
aa
aa
aa
aa
aa
aa
aa
aa
aa
aa
aa
aa
aa
aa
aa
aa
aa
aa
aa
aa
aa
aa
aa
aa
aa
aa
aa
aa
aa
aa
aa
aa
aa
aa
aa
aa
aa
aa
aa
aa
aa
aa
aa
aa
aa
aa
aa
aa
aa
aa
aa
aa
aa
aa
aa
aa
aa
aa
aa
aa
"}
(7,1,1) = {"
aa
aa
aa
aa
aa
aa
aa
aa
aa
aa
aa
aa
aa
aa
aa
aa
aa
aa
aa
aa
aa
aa
aa
aa
aa
aa
aa
aa
aa
aa
aa
aa
aa
aa
aa
aa
aa
aa
aa
aa
aa
aa
aa
aa
aa
aa
aa
aa
aa
aa
aa
aa
aa
aa
aa
aa
aa
aa
aa
aa
aa
aa
aa
aa
"}
(8,1,1) = {"
aa
aa
aa
aa
aa
aa
aa
aa
aa
aa
aa
aa
aa
aa
aa
aa
aa
aa
aa
aa
aa
aa
aa
aa
aa
aa
aa
aa
aa
aa
aa
aa
aa
aa
aa
aa
aa
aa
aa
aa
aa
aa
aa
aa
aa
aa
aa
aa
aa
aa
aa
aa
aa
aa
aa
aa
aa
aa
aa
aa
aa
aa
aa
aa
"}
(9,1,1) = {"
aa
aa
aa
aa
aa
aa
aa
aa
aa
aa
aa
aa
aa
aa
aa
aa
aa
aa
aa
aa
aa
aa
aa
aa
aa
aa
aa
aa
aa
aa
aa
aa
aa
aa
aa
aa
aa
aa
aa
aa
aa
aa
aa
aa
aa
aa
aa
aa
aa
aa
aa
aa
aa
aa
aa
aa
aa
aa
aa
aa
aa
aa
aa
aa
"}
(10,1,1) = {"
aa
aa
aa
aa
aa
aa
aa
aa
aa
aa
aa
aa
aa
aa
aa
aa
aa
aa
aa
aa
aa
aa
aa
aa
aa
aa
aa
aa
aa
aa
aa
aa
aa
aa
aa
aa
aa
aa
aa
aa
aa
aa
aa
aa
aa
aa
aa
aa
aa
aa
aa
aa
aa
aa
aa
aa
aa
aa
aa
aa
aa
aa
aa
aa
"}
(11,1,1) = {"
aa
aa
aa
aa
aa
aa
aa
aa
aa
aa
aa
ab
ac
ac
ac
ac
ac
ac
ac
ac
ac
ac
ac
ac
ac
ac
ac
ac
ac
ac
ac
ac
ac
ac
ac
ac
ac
ac
ac
ac
ac
ac
ac
ac
ac
ac
ac
ac
ac
ac
ac
ac
ac
ab
aa
aa
aa
aa
aa
aa
aa
aa
aa
aa
"}
(12,1,1) = {"
aa
aa
aa
aa
aa
aa
aa
aa
aa
aa
aa
ac
af
af
af
af
af
af
af
af
af
af
af
af
af
af
af
af
af
af
af
af
af
af
af
af
af
af
aR
af
af
af
af
af
af
af
af
af
af
af
af
af
af
ac
aa
aa
aa
aa
aa
aa
aa
aa
aa
aa
"}
(13,1,1) = {"
aa
aa
aa
aa
aa
aa
aa
aa
aa
aa
aa
ac
af
aj
aj
aj
aj
aj
aj
aj
aj
aj
ah
ah
aj
aj
aj
aj
aj
aj
aj
aj
aj
aj
af
aj
ac
ac
ac
ac
ac
aj
af
am
am
aJ
am
am
am
aJ
am
am
af
ac
aa
aa
aa
aa
aa
aa
aa
aa
aa
aa
"}
(14,1,1) = {"
aa
aa
aa
aa
aa
aa
aa
aa
aa
aa
aa
ac
af
aj
ad
ad
ad
ad
ad
ad
ad
aj
ai
ai
aj
ad
ad
ad
ad
ad
ad
ad
ad
aj
af
ac
aB
bf
bn
bo
bK
ac
af
am
ab
ab
ae
ae
ae
ab
ab
am
af
ac
aa
aa
aa
aa
aa
aa
aa
aa
aa
aa
"}
(15,1,1) = {"
aa
aa
aa
aa
aa
aa
aa
aa
aa
aa
aa
ac
af
aj
ad
ad
ad
ad
ad
ad
ad
aj
ai
ai
aj
ad
ad
ad
ad
ad
ad
ad
ad
aj
af
ac
aC
az
az
az
bL
aA
af
am
ab
an
an
an
an
an
ab
am
af
ac
aa
aa
aa
aa
aa
aa
aa
aa
aa
aa
"}
(16,1,1) = {"
aa
aa
aa
aa
aa
aa
aa
aa
aa
aa
aa
ac
af
aj
ad
ad
ad
ad
ad
ad
ad
aj
ad
ad
aj
ad
ad
ad
ad
ad
ad
ad
ad
aj
bc
ac
aD
az
az
az
bM
ac
aL
bu
ae
an
an
an
an
an
ae
am
af
ac
aa
aa
aa
aa
aa
aa
aa
aa
aa
aa
"}
(17,1,1) = {"
aa
aa
aa
aa
aa
aa
aa
aa
aa
aa
aa
ac
af
aj
ad
ad
ad
ad
ad
ad
ad
aj
ad
ad
aj
ad
ai
ai
ai
ai
ai
ad
ad
aj
af
ac
bd
az
az
az
bN
ac
af
bv
aY
aM
aM
ay
an
an
ae
am
af
ac
aa
aa
aa
aa
aa
aa
aa
aa
aa
aa
"}
(18,1,1) = {"
aa
aa
aa
aa
aa
aa
aa
aa
aa
aa
aa
ac
af
aj
ad
ad
ad
ad
ad
ad
ad
aj
ad
ad
aj
ad
ai
ai
ai
ai
ai
ad
ad
aj
af
ac
be
bg
bg
bJ
bO
ac
af
bw
ae
an
an
an
an
an
ae
am
af
ac
aa
aa
aa
aa
aa
aa
aa
aa
aa
aa
"}
(19,1,1) = {"
aa
aa
aa
aa
aa
aa
aa
aa
aa
aa
aa
ac
af
aj
ad
ad
ad
ad
ad
ad
ad
aj
ad
ad
aj
ad
ad
ad
ad
ad
ad
ad
ad
aj
af
aj
ac
ac
ac
ac
ac
aj
aQ
aO
ab
an
an
an
an
an
ab
am
af
ac
aa
aa
aa
aa
aa
aa
aa
aa
aa
aa
"}
(20,1,1) = {"
aa
aa
aa
aa
aa
aa
aa
aa
aa
aa
aa
ac
af
aj
ad
ad
ad
ad
ad
ad
ad
aj
ad
ad
aj
aj
aj
aj
ad
ad
ad
ad
ad
aj
af
af
af
af
aw
af
af
af
af
au
ab
ab
ae
ae
ae
ab
ab
am
af
ac
aa
aa
aa
aa
aa
aa
aa
aa
aa
aa
"}
(21,1,1) = {"
aa
aa
aa
aa
aa
aa
aa
aa
aa
aa
aa
ac
af
aj
ad
ad
ad
ad
ad
ad
ad
aj
ai
ai
ah
ad
ad
aj
ad
ad
ad
ad
ad
aj
af
af
af
af
af
af
af
af
af
am
am
aW
am
bx
by
aW
am
am
af
ac
aa
aa
aa
aa
aa
aa
aa
aa
aa
aa
"}
(22,1,1) = {"
aa
aa
aa
aa
aa
aa
aa
aa
aa
aa
aa
ac
af
aj
ad
ad
ad
ad
ad
ad
ad
aj
ai
ai
ah
ad
ad
aj
ad
ac
ac
ac
ac
ac
af
as
ax
aG
aS
bP
bR
bT
af
af
af
af
af
af
ao
ao
ao
af
af
ac
aa
aa
aa
aa
aa
aa
aa
aa
aa
aa
"}
(23,1,1) = {"
aa
aa
aa
aa
aa
aa
aa
aa
aa
aa
aa
ac
af
aj
ad
ad
ad
ad
ad
ad
ad
aj
aj
aj
aj
ah
ah
aj
ad
ac
bW
bW
bW
ac
af
at
ak
ai
ad
ad
bX
bU
al
ak
ai
ad
ad
ad
ag
ag
ap
ak
al
ac
aa
aa
aa
aa
aa
aa
aa
aa
aa
aa
"}
(24,1,1) = {"
aa
aa
aa
aa
aa
aa
aa
aa
aa
aa
aa
ac
af
aj
ad
ad
ad
ad
ad
ad
ad
ad
ad
ad
aj
ad
ad
aj
ad
ac
bW
bY
bW
ac
aL
at
ak
ai
ad
ad
ai
bU
al
ak
ai
ad
ad
ad
ag
ag
ap
ak
al
ac
aa
aa
aa
aa
aa
aa
aa
aa
aa
aa
"}
(25,1,1) = {"
aa
aa
aa
aa
aa
aa
aa
aa
aa
aa
aa
ac
af
aj
ad
ad
ad
ad
ad
ad
ad
ad
ad
ad
aj
ai
ai
aj
ad
ac
bW
bW
bW
ac
af
at
ak
ai
ad
ad
ai
bU
al
ak
ai
ad
ad
ad
ad
ad
ai
ak
aZ
ac
aa
aa
aa
aa
aa
aa
aa
aa
aa
aa
"}
(26,1,1) = {"
aa
aa
aa
aa
aa
aa
aa
aa
aa
aa
aa
ac
af
aj
ad
ad
ad
ad
ad
ad
ad
ad
ad
ad
aj
ai
ai
aj
aj
ac
ac
ac
ac
ac
af
at
ak
ai
ad
ad
bX
bU
al
ak
ai
ad
ad
ad
ad
ad
aq
ak
al
ac
aa
aa
aa
aa
aa
aa
aa
aa
aa
aa
"}
(27,1,1) = {"
aa
aa
aa
aa
aa
aa
aa
aa
aa
aa
aa
ac
af
aj
ad
ad
ad
ad
ad
ad
ad
ad
ad
ad
aj
ai
ai
ah
ak
ad
ad
ad
ak
ah
af
av
aE
aI
aV
bQ
bS
bV
af
aR
af
af
af
aR
af
af
af
af
af
ac
aa
aa
aa
aa
aa
aa
aa
aa
aa
aa
"}
(28,1,1) = {"
aa
aa
aa
aa
aa
aa
aa
aa
aa
aa
aa
ac
af
aj
ad
ad
ad
ad
ad
ad
ad
ad
ad
ad
aj
ai
ai
ah
ak
ad
ad
ad
ak
ah
af
af
af
af
aR
af
af
bt
af
aj
ac
aj
ac
aj
af
af
ar
af
af
ac
aa
aa
aa
aa
aa
aa
aa
aa
aa
aa
"}
(29,1,1) = {"
aa
aa
aa
aa
aa
aa
aa
aa
aa
aa
aa
ac
af
aj
ad
ad
ad
ad
ad
ad
ad
ad
ad
ad
aj
ai
ai
aj
aj
aj
aj
af
af
aj
ac
ac
ac
ac
ac
ac
ac
ac
ac
aj
aP
bi
aP
ac
af
af
af
af
af
ac
aa
aa
aa
aa
aa
aa
aa
aa
aa
aa
"}
(30,1,1) = {"
aa
aa
aa
aa
aa
aa
aa
aa
aa
aa
aa
ac
af
aj
aj
aj
aj
aj
aj
aj
aj
aj
aj
aj
aj
ad
ad
aj
ad
ad
aj
af
af
ac
aN
aN
aN
aP
bi
aP
aP
aP
aP
aP
aP
aP
aP
ac
af
af
af
af
af
ac
aa
aa
aa
aa
aa
aa
aa
aa
aa
aa
"}
(31,1,1) = {"
aa
aa
aa
aa
aa
aa
aa
aa
aa
aa
aa
ac
af
af
af
af
af
af
af
af
af
ah
ad
ad
ah
ad
ad
aj
ad
ad
aj
af
af
ac
aT
aT
aT
aP
aP
aP
aP
aP
aP
aP
aP
aP
aP
ac
af
af
af
af
af
ac
aa
aa
aa
aa
aa
aa
aa
aa
aa
aa
"}
(32,1,1) = {"
aa
aa
aa
aa
aa
aa
aa
aa
aa
aa
aa
ac
af
af
af
af
af
af
af
af
af
ah
ad
ad
ah
ad
ad
aj
ad
ad
aj
af
af
ac
bh
aP
aP
aP
aP
aP
aP
ba
bk
bb
ba
bk
bb
ac
af
af
af
af
af
ac
aa
aa
aa
aa
aa
aa
aa
aa
aa
aa
"}
(33,1,1) = {"
aa
aa
aa
aa
aa
aa
aa
aa
aa
aa
aa
ac
af
aj
aj
aj
aj
aj
aj
af
af
aj
aj
aj
aj
aj
aj
aj
ad
ad
aj
af
af
ac
aU
aU
aP
aX
bl
bm
bp
aj
ac
ac
ac
ac
ac
aj
af
af
af
af
af
ac
aa
aa
aa
aa
aa
aa
aa
aa
aa
aa
"}
(34,1,1) = {"
aa
aa
aa
aa
aa
aa
aa
aa
aa
aa
aa
ac
af
aj
ad
ad
ad
ad
aj
af
af
aj
ad
ad
ad
ad
ad
ad
ad
ad
aj
af
af
ac
aN
bE
aP
aX
bF
aK
aK
ac
af
af
af
af
af
af
af
af
af
af
af
ac
aa
aa
aa
aa
aa
aa
aa
aa
aa
aa
"}
(35,1,1) = {"
aa
aa
aa
aa
aa
aa
aa
aa
aa
aa
aa
ac
af
aj
ad
ad
ad
ad
aj
af
af
aj
ad
ad
ad
ad
ad
ad
ad
ad
aj
af
af
ac
aN
aN
aP
aX
bG
aK
bq
ac
af
af
af
af
af
af
af
af
af
af
af
ac
aa
aa
aa
aa
aa
aa
aa
aa
aa
aa
"}
(36,1,1) = {"
aa
aa
aa
aa
aa
aa
aa
aa
aa
aa
aa
ac
af
aj
ad
ad
ad
ad
aj
af
af
aj
ad
ad
ad
ad
ad
ad
ad
ad
aj
af
af
ac
aT
aT
aP
aX
aF
aK
br
ac
af
aj
ad
ad
ac
ac
ac
ac
ac
aj
af
ac
aa
aa
aa
aa
aa
aa
aa
aa
aa
aa
"}
(37,1,1) = {"
aa
aa
aa
aa
aa
aa
aa
aa
aa
aa
aa
ac
af
aj
ad
ad
ad
ad
aj
af
af
aj
ad
ad
ad
ad
ad
ad
ad
ad
aj
af
af
ac
bh
aP
aP
aX
bH
aK
aK
ac
af
ac
ad
ad
ad
ad
ad
ad
bz
ac
af
ac
aa
aa
aa
aa
aa
aa
aa
aa
aa
aa
"}
(38,1,1) = {"
aa
aa
aa
aa
aa
aa
aa
aa
aa
aa
aa
ac
af
aj
ad
ad
ad
ad
aj
af
af
aj
ad
ad
ad
ad
ad
ad
ad
ad
aj
af
af
ac
aU
aU
aP
aX
bI
aK
bj
ac
af
ac
ad
ad
ad
ad
ad
ad
bA
ac
af
ac
aa
aa
aa
aa
aa
aa
aa
aa
aa
aa
"}
(39,1,1) = {"
aa
aa
aa
aa
aa
aa
aa
aa
aa
aa
aa
ac
af
aj
ad
ad
ad
ad
aj
af
af
aj
aj
aj
aj
aj
aj
aj
aj
aj
aj
af
af
ac
aN
aN
aP
aP
aK
aK
bs
ac
af
ac
ad
ad
ad
ad
ad
ad
bB
ac
af
ac
aa
aa
aa
aa
aa
aa
aa
aa
aa
aa
"}
(40,1,1) = {"
aa
aa
aa
aa
aa
aa
aa
aa
aa
aa
aa
ac
af
aj
ad
ad
ad
ad
aj
af
af
af
af
af
af
af
af
af
af
af
af
af
af
aj
ac
ac
ac
ac
ac
ac
ac
aj
af
ac
ad
ad
ad
ad
ad
ad
bC
ac
af
ac
aa
aa
aa
aa
aa
aa
aa
aa
aa
aa
"}
(41,1,1) = {"
aa
aa
aa
aa
aa
aa
aa
aa
aa
aa
aa
ac
af
aj
ad
ad
ad
ad
aj
af
af
af
af
af
af
af
af
af
af
af
af
af
af
af
af
af
af
af
af
af
af
af
af
ac
ad
ad
ad
ad
ad
ad
bD
ac
af
ac
aa
aa
aa
aa
aa
aa
aa
aa
aa
aa
"}
(42,1,1) = {"
aa
aa
aa
aa
aa
aa
aa
aa
aa
aa
aa
ac
af
aj
aj
aj
aj
aj
aj
aj
aj
aj
aj
aj
aj
aj
aj
aj
ad
ad
ad
aj
aj
aj
aj
aj
aj
aj
aj
aj
aj
aj
aj
aj
ad
ad
ac
ac
ac
ac
ac
aj
af
ac
aa
aa
aa
aa
aa
aa
aa
aa
aa
aa
"}
(43,1,1) = {"
aa
aa
aa
aa
aa
aa
aa
aa
aa
aa
aa
ac
af
aj
ad
ad
ad
ad
ad
ad
ad
ad
ad
ad
ad
ad
ad
aj
ad
ad
ad
aj
ad
ad
ad
ad
ad
ad
ad
ad
ac
ad
ad
ad
ad
ad
ad
ad
ad
ad
ad
aj
af
ac
aa
aa
aa
aa
aa
aa
aa
aa
aa
aa
"}
(44,1,1) = {"
aa
aa
aa
aa
aa
aa
aa
aa
aa
aa
aa
ac
af
aj
ad
ad
ad
ad
ad
ad
ad
ad
ad
ad
ad
ad
ad
aj
ad
ad
ad
aj
ad
ad
ad
ad
ad
ad
ad
ad
ac
ad
ad
ad
ad
ad
ad
ad
ad
ad
ad
aj
af
ac
aa
aa
aa
aa
aa
aa
aa
aa
aa
aa
"}
(45,1,1) = {"
aa
aa
aa
aa
aa
aa
aa
aa
aa
aa
aa
ac
af
aj
ad
ad
ad
ad
ad
ad
ad
ad
ad
ad
ad
ad
ad
aj
ad
ad
ad
aj
ad
ad
ad
ad
ad
ad
ad
ad
ac
ad
ad
ad
ad
ad
ad
ad
ad
ad
ad
aj
af
ac
aa
aa
aa
aa
aa
aa
aa
aa
aa
aa
"}
(46,1,1) = {"
aa
aa
aa
aa
aa
aa
aa
aa
aa
aa
aa
ac
af
aj
ad
ad
ad
ad
ad
ad
ad
ad
ad
ad
ad
ad
ad
aj
ad
ad
ad
aj
ad
ad
ad
ad
ad
ad
ad
ad
ac
ad
ad
ad
ad
ad
ad
ad
ad
ad
ad
aj
af
ac
aa
aa
aa
aa
aa
aa
aa
aa
aa
aa
"}
(47,1,1) = {"
aa
aa
aa
aa
aa
aa
aa
aa
aa
aa
aa
ac
af
aj
ad
ad
ad
ad
ad
ad
ad
ad
ad
ad
ad
ad
ad
aj
ad
ad
ad
aj
ad
ad
ad
ad
ad
ad
ad
ad
ac
ad
ad
ad
ad
ad
ad
ad
ad
ad
ad
aj
af
ac
aa
aa
aa
aa
aa
aa
aa
aa
aa
aa
"}
(48,1,1) = {"
aa
aa
aa
aa
aa
aa
aa
aa
aa
aa
aa
ac
af
aj
ad
ad
ad
ad
ad
ad
ad
ad
ad
ad
ad
ad
ad
aj
ad
ad
ad
aj
ad
ad
ad
ad
ad
ad
ad
ad
aj
ad
ad
ad
ad
ad
ad
ad
ad
ad
ad
aj
af
ac
aa
aa
aa
aa
aa
aa
aa
aa
aa
aa
"}
(49,1,1) = {"
aa
aa
aa
aa
aa
aa
aa
aa
aa
aa
aa
ac
af
aj
ad
ad
ad
ad
ad
ad
ad
ad
ad
ad
ad
ad
ad
aj
ad
ad
ad
aj
ad
ad
ad
ad
ad
ad
ad
ad
ad
ad
ad
ad
ad
ad
ad
ad
ad
ad
ad
aj
af
ac
aa
aa
aa
aa
aa
aa
aa
aa
aa
aa
"}
(50,1,1) = {"
aa
aa
aa
aa
aa
aa
aa
aa
aa
aa
aa
ac
af
aj
ad
ad
ad
ad
ad
ad
ad
ad
ad
ad
ad
ad
ad
aj
ad
ad
ad
aj
ad
ad
ad
ad
ad
ad
ad
ad
aj
ad
ad
ad
ad
ad
ad
ad
ad
ad
ad
aj
af
ac
aa
aa
aa
aa
aa
aa
aa
aa
aa
aa
"}
(51,1,1) = {"
aa
aa
aa
aa
aa
aa
aa
aa
aa
aa
aa
ac
af
aj
aj
aj
aj
aj
aj
aj
aj
aj
aj
aj
aj
aj
aj
aj
ad
ad
ad
aj
aj
aj
aj
aj
aj
aj
aj
aj
aj
aj
aj
aj
aj
aj
aj
aj
aj
aj
aj
aj
af
ac
aa
aa
aa
aa
aa
aa
aa
aa
aa
aa
"}
(52,1,1) = {"
aa
aa
aa
aa
aa
aa
aa
aa
aa
aa
aa
ac
af
af
af
af
af
af
af
af
af
af
af
af
af
af
af
af
af
af
af
af
af
af
af
af
af
af
af
af
af
af
af
af
af
af
af
af
af
af
af
af
af
ac
aa
aa
aa
aa
aa
aa
aa
aa
aa
aa
"}
(53,1,1) = {"
aa
aa
aa
aa
aa
aa
aa
aa
aa
aa
aa
ab
ac
ac
ac
ac
ac
ac
ac
ac
ac
ac
ac
ac
ac
ac
ac
ac
ac
ac
ac
ac
ac
ac
ac
ac
ac
ac
ac
ac
ac
ac
ac
ac
ac
ac
ac
ac
ac
ac
ac
ac
ac
ab
aa
aa
aa
aa
aa
aa
aa
aa
aa
aa
"}
(54,1,1) = {"
aa
aa
aa
aa
aa
aa
aa
aa
aa
aa
aa
aa
aa
aa
aa
aa
aa
aa
aa
aa
aa
aa
aa
aa
aa
aa
aa
aa
aa
aa
aa
aa
aa
aa
aa
aa
aa
aa
aa
aa
aa
aa
aa
aa
aa
aa
aa
aa
aa
aa
aa
aa
aa
aa
aa
aa
aa
aa
aa
aa
aa
aa
aa
aa
"}
(55,1,1) = {"
aa
aa
aa
aa
aa
aa
aa
aa
aa
aa
aa
aa
aa
aa
aa
aa
aa
aa
aa
aa
aa
aa
aa
aa
aa
aa
aa
aa
aa
aa
aa
aa
aa
aa
aa
aa
aa
aa
aa
aa
aa
aa
aa
aa
aa
aa
aa
aa
aa
aa
aa
aa
aa
aa
aa
aa
aa
aa
aa
aa
aa
aa
aa
aa
"}
(56,1,1) = {"
aa
aa
aa
aa
aa
aa
aa
aa
aa
aa
aa
aa
aa
aa
aa
aa
aa
aa
aa
aa
aa
aa
aa
aa
aa
aa
aa
aa
aa
aa
aa
aa
aa
aa
aa
aa
aa
aa
aa
aa
aa
aa
aa
aa
aa
aa
aa
aa
aa
aa
aa
aa
aa
aa
aa
aa
aa
aa
aa
aa
aa
aa
aa
aa
"}
(57,1,1) = {"
aa
aa
aa
aa
aa
aa
aa
aa
aa
aa
aa
aa
aa
aa
aa
aa
aa
aa
aa
aa
aa
aa
aa
aa
aa
aa
aa
aa
aa
aa
aa
aa
aa
aa
aa
aa
aa
aa
aa
aa
aa
aa
aa
aa
aa
aa
aa
aa
aa
aa
aa
aa
aa
aa
aa
aa
aa
aa
aa
aa
aa
aa
aa
aa
"}
(58,1,1) = {"
aa
aa
aa
aa
aa
aa
aa
aa
aa
aa
aa
aa
aa
aa
aa
aa
aa
aa
aa
aa
aa
aa
aa
aa
aa
aa
aa
aa
aa
aa
aa
aa
aa
aa
aa
aa
aa
aa
aa
aa
aa
aa
aa
aa
aa
aa
aa
aa
aa
aa
aa
aa
aa
aa
aa
aa
aa
aa
aa
aa
aa
aa
aa
aa
"}
(59,1,1) = {"
aa
aa
aa
aa
aa
aa
aa
aa
aa
aa
aa
aa
aa
aa
aa
aa
aa
aa
aa
aa
aa
aa
aa
aa
aa
aa
aa
aa
aa
aa
aa
aa
aa
aa
aa
aa
aa
aa
aa
aa
aa
aa
aa
aa
aa
aa
aa
aa
aa
aa
aa
aa
aa
aa
aa
aa
aa
aa
aa
aa
aa
aa
aa
aa
"}
(60,1,1) = {"
aa
aa
aa
aa
aa
aa
aa
aa
aa
aa
aa
aa
aa
aa
aa
aa
aa
aa
aa
aa
aa
aa
aa
aa
aa
aa
aa
aa
aa
aa
aa
aa
aa
aa
aa
aa
aa
aa
aa
aa
aa
aa
aa
aa
aa
aa
aa
aa
aa
aa
aa
aa
aa
aa
aa
aa
aa
aa
aa
aa
aa
aa
aa
aa
"}
(61,1,1) = {"
aa
aa
aa
aa
aa
aa
aa
aa
aa
aa
aa
aa
aa
aa
aa
aa
aa
aa
aa
aa
aa
aa
aa
aa
aa
aa
aa
aa
aa
aa
aa
aa
aa
aa
aa
aa
aa
aa
aa
aa
aa
aa
aa
aa
aa
aa
aa
aa
aa
aa
aa
aa
aa
aa
aa
aa
aa
aa
aa
aa
aa
aa
aa
aa
"}
(62,1,1) = {"
aa
aa
aa
aa
aa
aa
aa
aa
aa
aa
aa
aa
aa
aa
aa
aa
aa
aa
aa
aa
aa
aa
aa
aa
aa
aa
aa
aa
aa
aa
aa
aa
aa
aa
aa
aa
aa
aa
aa
aa
aa
aa
aa
aa
aa
aa
aa
aa
aa
aa
aa
aa
aa
aa
aa
aa
aa
aa
aa
aa
aa
aa
aa
aa
"}
(63,1,1) = {"
aa
aa
aa
aa
aa
aa
aa
aa
aa
aa
aa
aa
aa
aa
aa
aa
aa
aa
aa
aa
aa
aa
aa
aa
aa
aa
aa
aa
aa
aa
aa
aa
aa
aa
aa
aa
aa
aa
aa
aa
aa
aa
aa
aa
aa
aa
aa
aa
aa
aa
aa
aa
aa
aa
aa
aa
aa
aa
aa
aa
aa
aa
aa
aa
"}
(64,1,1) = {"
aa
aa
aa
aa
aa
aa
aa
aa
aa
aa
aa
aa
aa
aa
aa
aa
aa
aa
aa
aa
aa
aa
aa
aa
aa
aa
aa
aa
aa
aa
aa
aa
aa
aa
aa
aa
aa
aa
aa
aa
aa
aa
aa
aa
aa
aa
aa
aa
aa
aa
aa
aa
aa
aa
aa
aa
aa
aa
aa
aa
aa
aa
aa
aa
"}
