//MAP CONVERTED BY dmm2tgm.py THIS HEADER COMMENT PREVENTS RECONVERSION, DO NOT REMOVE
"a" = (
/turf/simulated/ocean,
/area/space/ocean)
"b" = (
/turf/simulated/wall/r_wall,
/area/cassini)
"c" = (
/obj/effect/wingrille_spawn/reinforced/full,
/turf/simulated/floor/plating,
/area/cassini)
"d" = (
/turf/simulated/floor/tiled,
/area/cassini)
"e" = (
/obj/effect/wingrille_spawn/reinforced_phoron/full,
/turf/simulated/floor/plating,
/area/cassini)
"f" = (
/turf/simulated/floor/tiled/dark,
/area/cassini)
"g" = (
/obj/effect/landmark{
	name = "JoinLate"
	},
/turf/simulated/floor/tiled,
/area/cassini)
"h" = (
/turf/simulated/floor/tiled/dark/monotile,
/area/cassini)
"i" = (
/turf/simulated/floor/tiled/steel_grid,
/area/cassini)
"j" = (
/turf/simulated/wall,
/area/cassini)
"k" = (
/turf/simulated/floor/tiled/steel_ridged,
/area/cassini)
"l" = (
/turf/simulated/floor/tiled/monotile,
/area/cassini)
"m" = (
/turf/simulated/floor/tiled/techmaint,
/area/cassini)
"n" = (
/turf/simulated/floor/reinforced/airless,
/area/cassini)
"o" = (
/obj/effect/landmark{
	name = "JoinLate"
	},
/turf/simulated/floor/tiled/dark,
/area/cassini)
"p" = (
/obj/effect/landmark{
	name = "JoinLate"
	},
/turf/simulated/floor/tiled/steel_grid,
/area/cassini)
"q" = (
/obj/effect/landmark/test/safe_turf,
/turf/simulated/floor/tiled/steel_grid,
/area/cassini)
"r" = (
/obj/effect/landmark/start,
/turf/simulated/floor/tiled/dark,
/area/cassini)
"u" = (
/obj/structure/cable{
	icon_state = "0-8"
	},
/obj/machinery/power/apc/high{
	pixel_y = -24
	},
/turf/simulated/floor/tiled/techmaint,
/area/cassini)
"w" = (
/obj/structure/closet/secure_closet/cassini,
/turf/simulated/floor/tiled/dark,
/area/cassini)
"y" = (
/obj/machinery/power/debug_items/infinite_generator,
/obj/structure/cable,
/turf/simulated/floor/reinforced/airless,
/area/cassini)
"z" = (
/obj/structure/closet/cassini,
/turf/simulated/floor/tiled/dark,
/area/cassini)
"A" = (
/obj/machinery/light{
	icon_state = "tube_map";
	dir = 8
	},
/obj/structure/closet/secure_closet/cassini,
/turf/simulated/floor/tiled/dark,
/area/cassini)
"C" = (
/obj/structure/cable{
	icon_state = "2-4"
	},
/turf/simulated/floor/tiled/techmaint,
/area/cassini)
"F" = (
/obj/structure/closet/secure_closet/cassini/police,
/turf/simulated/floor/tiled/dark,
/area/cassini)
"J" = (
/obj/machinery/light{
	icon_state = "tube_map";
	dir = 4
	},
/turf/simulated/floor/tiled/techmaint,
/area/cassini)
"K" = (
/obj/machinery/light{
	icon_state = "tube_map";
	dir = 4
	},
/obj/structure/closet/secure_closet/cassini/utilities,
/turf/simulated/floor/tiled/dark,
/area/cassini)
"L" = (
/obj/machinery/light{
	icon_state = "tube_map";
	dir = 1
	},
/turf/simulated/floor/tiled/dark,
/area/cassini)
"M" = (
/obj/structure/cable{
	icon_state = "1-2"
	},
/turf/simulated/floor/reinforced/airless,
/area/cassini)
"O" = (
/obj/structure/cable{
	icon_state = "4-8"
	},
/turf/simulated/floor/tiled/techmaint,
/area/cassini)
"R" = (
/obj/machinery/light{
	icon_state = "tube_map";
	dir = 4
	},
/turf/simulated/floor/tiled/dark,
/area/cassini)
"T" = (
/obj/structure/closet/secure_closet/cassini/medical,
/turf/simulated/floor/tiled/dark,
/area/cassini)
"U" = (
/obj/structure/closet/secure_closet/cassini/utilities,
/turf/simulated/floor/tiled/dark,
/area/cassini)
"W" = (
/obj/machinery/light{
	icon_state = "tube_map";
	dir = 8
	},
/turf/simulated/floor/tiled/techmaint,
/area/cassini)
"Y" = (
/obj/effect/wingrille_spawn/reinforced_phoron/full,
/obj/structure/cable{
	icon_state = "1-2"
	},
/turf/simulated/floor/plating,
/area/cassini)
"Z" = (
/obj/machinery/light,
/turf/simulated/floor/tiled/monotile,
/area/cassini)

(1,1,1) = {"
a
a
a
a
a
a
a
a
a
a
a
a
a
a
a
a
a
a
a
a
a
a
a
a
a
a
a
a
a
a
a
a
a
a
a
a
a
a
a
a
a
a
a
a
a
a
a
a
a
a
a
a
a
a
a
a
a
a
a
a
a
a
a
a
"}
(2,1,1) = {"
a
a
a
a
a
a
a
a
a
a
a
a
a
a
a
a
a
a
a
a
a
a
a
a
a
a
a
a
a
a
a
a
a
a
a
a
a
a
a
a
a
a
a
a
a
a
a
a
a
a
a
a
a
a
a
a
a
a
a
a
a
a
a
a
"}
(3,1,1) = {"
a
a
a
a
a
a
a
a
a
a
a
a
a
a
a
a
a
a
a
a
a
a
a
a
a
a
a
a
a
a
a
a
a
a
a
a
a
a
a
a
a
a
a
a
a
a
a
a
a
a
a
a
a
a
a
a
a
a
a
a
a
a
a
a
"}
(4,1,1) = {"
a
a
a
a
a
a
a
a
a
a
a
a
a
a
a
a
a
a
a
a
a
a
a
a
a
a
a
a
a
a
a
a
a
a
a
a
a
a
a
a
a
a
a
a
a
a
a
a
a
a
a
a
a
a
a
a
a
a
a
a
a
a
a
a
"}
(5,1,1) = {"
a
a
a
a
a
a
a
a
a
a
a
a
a
a
a
a
a
a
a
a
a
a
a
a
a
a
a
a
a
a
a
a
a
a
a
a
a
a
a
a
a
a
a
a
a
a
a
a
a
a
a
a
a
a
a
a
a
a
a
a
a
a
a
a
"}
(6,1,1) = {"
a
a
a
a
a
a
a
a
a
a
a
a
a
a
a
a
a
a
a
a
a
a
a
a
a
a
a
a
a
a
a
a
a
a
a
a
a
a
a
a
a
a
a
a
a
a
a
a
a
a
a
a
a
a
a
a
a
a
a
a
a
a
a
a
"}
(7,1,1) = {"
a
a
a
a
a
a
a
a
a
a
a
a
a
a
a
a
a
a
a
a
a
a
a
a
a
a
a
a
a
a
a
a
a
a
a
a
a
a
a
a
a
a
a
a
a
a
a
a
a
a
a
a
a
a
a
a
a
a
a
a
a
a
a
a
"}
(8,1,1) = {"
a
a
a
a
a
a
a
a
a
a
a
a
a
a
a
a
a
a
a
a
a
a
a
a
a
a
a
a
a
a
a
a
a
a
a
a
a
a
a
a
a
a
a
a
a
a
a
a
a
a
a
a
a
a
a
a
a
a
a
a
a
a
a
a
"}
(9,1,1) = {"
a
a
a
a
a
a
a
a
a
a
a
a
a
a
a
a
a
a
a
a
a
a
a
a
a
a
a
a
a
a
a
a
a
a
a
a
a
a
a
a
a
a
a
a
a
a
a
a
a
a
a
a
a
a
a
a
a
a
a
a
a
a
a
a
"}
(10,1,1) = {"
a
a
a
a
a
a
a
a
a
a
a
a
a
a
a
a
a
a
a
a
a
a
a
a
a
a
a
a
a
a
a
a
a
a
a
a
a
a
a
a
a
a
a
a
a
a
a
a
a
a
a
a
a
a
a
a
a
a
a
a
a
a
a
a
"}
(11,1,1) = {"
a
a
a
a
a
a
a
a
a
a
a
b
c
c
c
c
c
c
c
c
c
c
c
c
c
c
c
c
c
c
c
c
c
c
c
c
c
c
c
c
c
c
c
c
c
c
c
c
c
c
c
c
c
b
a
a
a
a
a
a
a
a
a
a
"}
(12,1,1) = {"
a
a
a
a
a
a
a
a
a
a
a
c
f
f
f
f
f
f
f
f
f
f
f
f
f
f
f
f
f
f
f
f
f
f
f
f
f
f
f
f
f
f
f
f
f
f
f
f
f
f
f
f
f
c
a
a
a
a
a
a
a
a
a
a
"}
(13,1,1) = {"
a
a
a
a
a
a
a
a
a
a
a
c
f
j
j
j
j
j
j
j
j
j
h
h
j
j
j
j
j
j
j
j
j
j
f
j
j
j
j
j
j
j
f
m
m
J
m
m
m
J
m
m
f
c
a
a
a
a
a
a
a
a
a
a
"}
(14,1,1) = {"
a
a
a
a
a
a
a
a
a
a
a
c
f
j
d
d
d
d
d
d
d
j
i
i
j
d
d
d
d
d
d
d
d
j
f
j
d
d
d
d
d
j
f
m
b
b
e
e
e
b
b
m
f
c
a
a
a
a
a
a
a
a
a
a
"}
(15,1,1) = {"
a
a
a
a
a
a
a
a
a
a
a
c
f
j
d
d
d
d
d
d
d
j
i
i
j
d
d
d
d
d
d
d
d
j
f
j
d
d
d
d
d
j
f
m
b
n
n
n
n
n
b
m
f
c
a
a
a
a
a
a
a
a
a
a
"}
(16,1,1) = {"
a
a
a
a
a
a
a
a
a
a
a
c
f
j
d
d
d
d
d
d
d
j
d
d
j
d
d
d
d
d
d
d
d
j
f
j
d
d
d
d
d
d
f
m
e
n
n
n
n
n
e
m
f
c
a
a
a
a
a
a
a
a
a
a
"}
(17,1,1) = {"
a
a
a
a
a
a
a
a
a
a
a
c
f
j
d
d
d
d
d
d
d
j
d
d
j
d
i
i
i
i
i
d
d
j
f
j
d
d
d
d
d
j
f
C
Y
M
M
y
n
n
e
m
f
c
a
a
a
a
a
a
a
a
a
a
"}
(18,1,1) = {"
a
a
a
a
a
a
a
a
a
a
a
c
f
j
d
d
d
d
d
d
d
j
d
d
j
d
i
i
i
i
i
d
d
j
f
j
d
d
d
d
d
j
f
O
e
n
n
n
n
n
e
m
f
c
a
a
a
a
a
a
a
a
a
a
"}
(19,1,1) = {"
a
a
a
a
a
a
a
a
a
a
a
c
f
j
d
d
d
d
d
d
d
j
d
d
j
d
d
d
d
d
d
d
d
j
f
j
d
d
d
d
d
j
f
O
b
n
n
n
n
n
b
m
f
c
a
a
a
a
a
a
a
a
a
a
"}
(20,1,1) = {"
a
a
a
a
a
a
a
a
a
a
a
c
f
j
d
d
d
d
d
d
d
j
d
d
j
j
j
j
d
d
d
d
d
j
f
j
j
j
j
j
j
j
f
u
b
b
e
e
e
b
b
m
f
c
a
a
a
a
a
a
a
a
a
a
"}
(21,1,1) = {"
a
a
a
a
a
a
a
a
a
a
a
c
f
j
d
d
d
d
d
d
d
j
i
i
h
d
d
j
d
d
d
d
d
j
f
z
w
A
z
z
w
w
f
m
m
W
m
m
m
W
m
m
f
c
a
a
a
a
a
a
a
a
a
a
"}
(22,1,1) = {"
a
a
a
a
a
a
a
a
a
a
a
c
f
j
d
d
d
d
d
d
d
j
i
i
h
d
d
j
d
d
d
d
d
j
f
l
k
i
d
d
i
k
f
f
f
f
f
f
o
o
o
f
f
c
a
a
a
a
a
a
a
a
a
a
"}
(23,1,1) = {"
a
a
a
a
a
a
a
a
a
a
a
c
f
j
d
d
d
d
d
d
d
j
j
j
j
h
h
j
d
d
d
d
d
j
f
l
k
i
d
d
i
k
l
k
i
d
d
d
g
g
p
k
l
c
a
a
a
a
a
a
a
a
a
a
"}
(24,1,1) = {"
a
a
a
a
a
a
a
a
a
a
a
c
f
j
d
d
d
d
d
d
d
d
d
d
j
d
d
j
d
d
d
d
d
j
f
l
k
i
d
d
i
k
l
k
i
d
d
d
g
g
p
k
l
c
a
a
a
a
a
a
a
a
a
a
"}
(25,1,1) = {"
a
a
a
a
a
a
a
a
a
a
a
c
f
j
d
d
d
d
d
d
d
d
d
d
j
i
i
j
d
d
d
d
d
j
L
l
k
i
d
d
i
k
l
k
i
d
d
d
d
d
i
k
Z
c
a
a
a
a
a
a
a
a
a
a
"}
(26,1,1) = {"
a
a
a
a
a
a
a
a
a
a
a
c
f
j
d
d
d
d
d
d
d
d
d
d
j
i
i
j
j
j
j
j
j
j
f
l
k
i
d
d
i
k
l
k
i
d
d
d
d
d
q
k
l
c
a
a
a
a
a
a
a
a
a
a
"}
(27,1,1) = {"
a
a
a
a
a
a
a
a
a
a
a
c
f
j
d
d
d
d
d
d
d
d
d
d
j
i
i
h
k
d
d
d
k
h
f
l
k
i
d
d
i
k
f
R
f
f
f
R
f
f
f
f
f
c
a
a
a
a
a
a
a
a
a
a
"}
(28,1,1) = {"
a
a
a
a
a
a
a
a
a
a
a
c
f
j
d
d
d
d
d
d
d
d
d
d
j
i
i
h
k
d
d
d
k
h
f
f
z
K
U
F
F
T
T
j
j
j
j
j
f
f
r
f
f
c
a
a
a
a
a
a
a
a
a
a
"}
(29,1,1) = {"
a
a
a
a
a
a
a
a
a
a
a
c
f
j
d
d
d
d
d
d
d
d
d
d
j
i
i
j
j
j
j
j
j
j
f
f
j
j
j
j
j
j
j
j
d
d
d
j
f
f
f
f
f
c
a
a
a
a
a
a
a
a
a
a
"}
(30,1,1) = {"
a
a
a
a
a
a
a
a
a
a
a
c
f
j
j
j
j
j
j
j
j
j
j
j
j
d
d
j
d
d
d
d
d
j
f
f
j
d
d
d
d
d
d
d
d
d
d
j
f
f
f
f
f
c
a
a
a
a
a
a
a
a
a
a
"}
(31,1,1) = {"
a
a
a
a
a
a
a
a
a
a
a
c
f
f
f
f
f
f
f
f
f
h
d
d
h
d
d
j
d
d
d
d
d
j
f
f
j
d
d
d
d
d
d
d
d
d
d
j
f
f
f
f
f
c
a
a
a
a
a
a
a
a
a
a
"}
(32,1,1) = {"
a
a
a
a
a
a
a
a
a
a
a
c
f
f
f
f
f
f
f
f
f
h
d
d
h
d
d
j
d
d
d
d
d
j
f
f
j
d
d
d
d
d
d
d
d
d
d
j
f
f
f
f
f
c
a
a
a
a
a
a
a
a
a
a
"}
(33,1,1) = {"
a
a
a
a
a
a
a
a
a
a
a
c
f
j
j
j
j
j
j
f
f
j
j
j
j
j
j
j
d
d
d
d
d
j
f
f
j
d
d
d
j
j
j
j
j
j
j
j
f
f
f
f
f
c
a
a
a
a
a
a
a
a
a
a
"}
(34,1,1) = {"
a
a
a
a
a
a
a
a
a
a
a
c
f
j
d
d
d
d
j
f
f
j
d
d
d
d
d
d
d
d
d
d
d
j
f
f
j
d
d
d
j
f
f
f
f
f
f
f
f
f
f
f
f
c
a
a
a
a
a
a
a
a
a
a
"}
(35,1,1) = {"
a
a
a
a
a
a
a
a
a
a
a
c
f
j
d
d
d
d
j
f
f
j
d
d
d
d
d
d
d
d
d
d
d
j
f
f
j
d
d
d
j
f
f
f
f
f
f
f
f
f
f
f
f
c
a
a
a
a
a
a
a
a
a
a
"}
(36,1,1) = {"
a
a
a
a
a
a
a
a
a
a
a
c
f
j
d
d
d
d
j
f
f
j
d
d
d
d
d
d
d
d
d
d
d
j
f
f
j
d
d
d
j
f
f
j
j
j
j
j
j
j
j
j
f
c
a
a
a
a
a
a
a
a
a
a
"}
(37,1,1) = {"
a
a
a
a
a
a
a
a
a
a
a
c
f
j
d
d
d
d
j
f
f
j
d
d
d
d
d
d
d
d
d
d
d
j
f
f
j
d
d
d
j
f
f
j
d
d
d
d
d
d
d
j
f
c
a
a
a
a
a
a
a
a
a
a
"}
(38,1,1) = {"
a
a
a
a
a
a
a
a
a
a
a
c
f
j
d
d
d
d
j
f
f
j
d
d
d
d
d
d
d
d
d
d
d
j
f
f
j
d
d
d
j
f
f
j
d
d
d
d
d
d
d
j
f
c
a
a
a
a
a
a
a
a
a
a
"}
(39,1,1) = {"
a
a
a
a
a
a
a
a
a
a
a
c
f
j
d
d
d
d
j
f
f
j
j
j
j
j
j
j
j
j
j
j
d
j
f
f
j
d
d
d
j
f
f
j
d
d
d
d
d
d
d
j
f
c
a
a
a
a
a
a
a
a
a
a
"}
(40,1,1) = {"
a
a
a
a
a
a
a
a
a
a
a
c
f
j
d
d
d
d
j
f
f
f
f
f
f
f
f
f
f
f
f
j
j
j
f
f
j
j
j
j
j
f
f
j
d
d
d
d
d
d
d
j
f
c
a
a
a
a
a
a
a
a
a
a
"}
(41,1,1) = {"
a
a
a
a
a
a
a
a
a
a
a
c
f
j
d
d
d
d
j
f
f
f
f
f
f
f
f
f
f
f
f
f
f
f
f
f
f
f
f
f
f
f
f
j
d
d
d
d
d
d
d
j
f
c
a
a
a
a
a
a
a
a
a
a
"}
(42,1,1) = {"
a
a
a
a
a
a
a
a
a
a
a
c
f
j
j
j
j
j
j
j
j
j
j
j
j
j
j
j
d
d
d
j
j
j
j
j
j
j
j
j
j
j
j
j
d
d
d
d
d
d
d
j
f
c
a
a
a
a
a
a
a
a
a
a
"}
(43,1,1) = {"
a
a
a
a
a
a
a
a
a
a
a
c
f
j
d
d
d
d
d
d
d
d
d
d
d
d
d
j
d
d
d
j
d
d
d
d
d
d
d
d
d
d
d
d
d
d
d
d
d
d
d
j
f
c
a
a
a
a
a
a
a
a
a
a
"}
(44,1,1) = {"
a
a
a
a
a
a
a
a
a
a
a
c
f
j
d
d
d
d
d
d
d
d
d
d
d
d
d
j
d
d
d
j
d
d
d
d
d
d
d
d
d
d
d
d
d
d
d
d
d
d
d
j
f
c
a
a
a
a
a
a
a
a
a
a
"}
(45,1,1) = {"
a
a
a
a
a
a
a
a
a
a
a
c
f
j
d
d
d
d
d
d
d
d
d
d
d
d
d
j
d
d
d
j
d
d
d
d
d
d
d
d
d
d
d
d
d
d
d
d
d
d
d
j
f
c
a
a
a
a
a
a
a
a
a
a
"}
(46,1,1) = {"
a
a
a
a
a
a
a
a
a
a
a
c
f
j
d
d
d
d
d
d
d
d
d
d
d
d
d
j
d
d
d
j
d
d
d
d
d
d
d
d
d
d
d
d
d
d
d
d
d
d
d
j
f
c
a
a
a
a
a
a
a
a
a
a
"}
(47,1,1) = {"
a
a
a
a
a
a
a
a
a
a
a
c
f
j
d
d
d
d
d
d
d
d
d
d
d
d
d
j
d
d
d
j
d
d
d
d
d
d
d
d
d
d
d
d
d
d
d
d
d
d
d
j
f
c
a
a
a
a
a
a
a
a
a
a
"}
(48,1,1) = {"
a
a
a
a
a
a
a
a
a
a
a
c
f
j
d
d
d
d
d
d
d
d
d
d
d
d
d
j
d
d
d
j
d
d
d
d
d
d
d
d
d
d
d
d
d
d
d
d
d
d
d
j
f
c
a
a
a
a
a
a
a
a
a
a
"}
(49,1,1) = {"
a
a
a
a
a
a
a
a
a
a
a
c
f
j
d
d
d
d
d
d
d
d
d
d
d
d
d
j
d
d
d
j
d
d
d
d
d
d
d
d
d
d
d
d
d
d
d
d
d
d
d
j
f
c
a
a
a
a
a
a
a
a
a
a
"}
(50,1,1) = {"
a
a
a
a
a
a
a
a
a
a
a
c
f
j
d
d
d
d
d
d
d
d
d
d
d
d
d
j
d
d
d
j
d
d
d
d
d
d
d
j
j
d
d
d
d
d
d
d
d
d
d
j
f
c
a
a
a
a
a
a
a
a
a
a
"}
(51,1,1) = {"
a
a
a
a
a
a
a
a
a
a
a
c
f
j
j
j
j
j
j
j
j
j
j
j
j
j
j
j
d
d
d
j
j
j
j
j
j
j
j
j
j
j
j
j
j
j
j
j
j
j
j
j
f
c
a
a
a
a
a
a
a
a
a
a
"}
(52,1,1) = {"
a
a
a
a
a
a
a
a
a
a
a
c
f
f
f
f
f
f
f
f
f
f
f
f
f
f
f
f
f
f
f
f
f
f
f
f
f
f
f
f
f
f
f
f
f
f
f
f
f
f
f
f
f
c
a
a
a
a
a
a
a
a
a
a
"}
(53,1,1) = {"
a
a
a
a
a
a
a
a
a
a
a
b
c
c
c
c
c
c
c
c
c
c
c
c
c
c
c
c
c
c
c
c
c
c
c
c
c
c
c
c
c
c
c
c
c
c
c
c
c
c
c
c
c
b
a
a
a
a
a
a
a
a
a
a
"}
(54,1,1) = {"
a
a
a
a
a
a
a
a
a
a
a
a
a
a
a
a
a
a
a
a
a
a
a
a
a
a
a
a
a
a
a
a
a
a
a
a
a
a
a
a
a
a
a
a
a
a
a
a
a
a
a
a
a
a
a
a
a
a
a
a
a
a
a
a
"}
(55,1,1) = {"
a
a
a
a
a
a
a
a
a
a
a
a
a
a
a
a
a
a
a
a
a
a
a
a
a
a
a
a
a
a
a
a
a
a
a
a
a
a
a
a
a
a
a
a
a
a
a
a
a
a
a
a
a
a
a
a
a
a
a
a
a
a
a
a
"}
(56,1,1) = {"
a
a
a
a
a
a
a
a
a
a
a
a
a
a
a
a
a
a
a
a
a
a
a
a
a
a
a
a
a
a
a
a
a
a
a
a
a
a
a
a
a
a
a
a
a
a
a
a
a
a
a
a
a
a
a
a
a
a
a
a
a
a
a
a
"}
(57,1,1) = {"
a
a
a
a
a
a
a
a
a
a
a
a
a
a
a
a
a
a
a
a
a
a
a
a
a
a
a
a
a
a
a
a
a
a
a
a
a
a
a
a
a
a
a
a
a
a
a
a
a
a
a
a
a
a
a
a
a
a
a
a
a
a
a
a
"}
(58,1,1) = {"
a
a
a
a
a
a
a
a
a
a
a
a
a
a
a
a
a
a
a
a
a
a
a
a
a
a
a
a
a
a
a
a
a
a
a
a
a
a
a
a
a
a
a
a
a
a
a
a
a
a
a
a
a
a
a
a
a
a
a
a
a
a
a
a
"}
(59,1,1) = {"
a
a
a
a
a
a
a
a
a
a
a
a
a
a
a
a
a
a
a
a
a
a
a
a
a
a
a
a
a
a
a
a
a
a
a
a
a
a
a
a
a
a
a
a
a
a
a
a
a
a
a
a
a
a
a
a
a
a
a
a
a
a
a
a
"}
(60,1,1) = {"
a
a
a
a
a
a
a
a
a
a
a
a
a
a
a
a
a
a
a
a
a
a
a
a
a
a
a
a
a
a
a
a
a
a
a
a
a
a
a
a
a
a
a
a
a
a
a
a
a
a
a
a
a
a
a
a
a
a
a
a
a
a
a
a
"}
(61,1,1) = {"
a
a
a
a
a
a
a
a
a
a
a
a
a
a
a
a
a
a
a
a
a
a
a
a
a
a
a
a
a
a
a
a
a
a
a
a
a
a
a
a
a
a
a
a
a
a
a
a
a
a
a
a
a
a
a
a
a
a
a
a
a
a
a
a
"}
(62,1,1) = {"
a
a
a
a
a
a
a
a
a
a
a
a
a
a
a
a
a
a
a
a
a
a
a
a
a
a
a
a
a
a
a
a
a
a
a
a
a
a
a
a
a
a
a
a
a
a
a
a
a
a
a
a
a
a
a
a
a
a
a
a
a
a
a
a
"}
(63,1,1) = {"
a
a
a
a
a
a
a
a
a
a
a
a
a
a
a
a
a
a
a
a
a
a
a
a
a
a
a
a
a
a
a
a
a
a
a
a
a
a
a
a
a
a
a
a
a
a
a
a
a
a
a
a
a
a
a
a
a
a
a
a
a
a
a
a
"}
(64,1,1) = {"
a
a
a
a
a
a
a
a
a
a
a
a
a
a
a
a
a
a
a
a
a
a
a
a
a
a
a
a
a
a
a
a
a
a
a
a
a
a
a
a
a
a
a
a
a
a
a
a
a
a
a
a
a
a
a
a
a
a
a
a
a
a
a
a
"}
