"a" = (/turf/simulated/ocean,/area/space/ocean)
"b" = (/turf/simulated/wall/r_wall,/area/cassini)
"c" = (/obj/effect/wingrille_spawn/reinforced/full,/turf/simulated/floor/plating,/area/cassini)
"d" = (/turf/simulated/floor/tiled,/area/cassini)
"e" = (/obj/effect/wingrille_spawn/reinforced_phoron/full,/turf/simulated/floor/plating,/area/cassini)
"f" = (/turf/simulated/floor/tiled/dark,/area/cassini)
"g" = (/obj/effect/landmark{name = "JoinLate"},/turf/simulated/floor/tiled,/area/cassini)
"h" = (/turf/simulated/floor/tiled/dark/monotile,/area/cassini)
"i" = (/turf/simulated/floor/tiled/steel_grid,/area/cassini)
"j" = (/turf/simulated/wall,/area/cassini)
"k" = (/turf/simulated/floor/tiled/steel_ridged,/area/cassini)
"l" = (/turf/simulated/floor/tiled/monotile,/area/cassini)
"m" = (/turf/simulated/floor/tiled/techmaint,/area/cassini)
"n" = (/turf/simulated/floor/reinforced/airless,/area/cassini)
"o" = (/obj/effect/landmark{name = "JoinLate"},/turf/simulated/floor/tiled/dark,/area/cassini)
"p" = (/obj/effect/landmark{name = "JoinLate"},/turf/simulated/floor/tiled/steel_grid,/area/cassini)
"q" = (/obj/effect/landmark/test/safe_turf,/turf/simulated/floor/tiled/steel_grid,/area/cassini)
"r" = (/obj/effect/landmark/start,/turf/simulated/floor/tiled/dark,/area/cassini)

(1,1,1) = {"
aaaaaaaaaaaaaaaaaaaaaaaaaaaaaaaaaaaaaaaaaaaaaaaaaaaaaaaaaaaaaaaa
aaaaaaaaaaaaaaaaaaaaaaaaaaaaaaaaaaaaaaaaaaaaaaaaaaaaaaaaaaaaaaaa
aaaaaaaaaaaaaaaaaaaaaaaaaaaaaaaaaaaaaaaaaaaaaaaaaaaaaaaaaaaaaaaa
aaaaaaaaaaaaaaaaaaaaaaaaaaaaaaaaaaaaaaaaaaaaaaaaaaaaaaaaaaaaaaaa
aaaaaaaaaaaaaaaaaaaaaaaaaaaaaaaaaaaaaaaaaaaaaaaaaaaaaaaaaaaaaaaa
aaaaaaaaaaaaaaaaaaaaaaaaaaaaaaaaaaaaaaaaaaaaaaaaaaaaaaaaaaaaaaaa
aaaaaaaaaaaaaaaaaaaaaaaaaaaaaaaaaaaaaaaaaaaaaaaaaaaaaaaaaaaaaaaa
aaaaaaaaaaaaaaaaaaaaaaaaaaaaaaaaaaaaaaaaaaaaaaaaaaaaaaaaaaaaaaaa
aaaaaaaaaaaaaaaaaaaaaaaaaaaaaaaaaaaaaaaaaaaaaaaaaaaaaaaaaaaaaaaa
aaaaaaaaaaaaaaaaaaaaaaaaaaaaaaaaaaaaaaaaaaaaaaaaaaaaaaaaaaaaaaaa
aaaaaaaaaaaaaaaaaaaaaaaaaaaaaaaaaaaaaaaaaaaaaaaaaaaaaaaaaaaaaaaa
aaaaaaaaaabcccccccccccccccccccccccccccccccccccccccccbaaaaaaaaaaa
aaaaaaaaaacfffffffffffffffffffffffffffffffffffffffffcaaaaaaaaaaa
aaaaaaaaaacfjjjjjjjjjjjjjjjjjjffjjjjjjjjjjjjjjjjjjjfcaaaaaaaaaaa
aaaaaaaaaacfjddddddddddddddddjffjddddddddjddddddddjfcaaaaaaaaaaa
aaaaaaaaaacfjddddddddddddddddjffjddddddddjddddddddjfcaaaaaaaaaaa
aaaaaaaaaacfjddddddddddddddddjffjddddddddjddddddddjfcaaaaaaaaaaa
aaaaaaaaaacfjddddddddddddddddjffjddddddddjddddddddjfcaaaaaaaaaaa
aaaaaaaaaacfjddddddddddddddddjffjjjjjjjjjjddddddddjfcaaaaaaaaaaa
aaaaaaaaaacfjddddddddddddddddjfffffffffffjddddddddjfcaaaaaaaaaaa
aaaaaaaaaacfjddddddddddddddddjfffffffffffjddddddddjfcaaaaaaaaaaa
aaaaaaaaaacfjjjjjjjjjjjddddddjhhjjjjjjjffjddddddddjfcaaaaaaaaaaa
aaaaaaaaaacfhiidddddiijddddddjddjdddddjffjddddddddjfcaaaaaaaaaaa
aaaaaaaaaacfhiidddddiijddddddjddjdddddjffjddddddddjfcaaaaaaaaaaa
aaaaaaaaaacfjjjjjjjjhhjjjjjjjjhhjdddddjffjddddddddjfcaaaaaaaaaaa
aaaaaaaaaacfjddddddjddhdiiiiidddjdddddjffjddddddddjfcaaaaaaaaaaa
aaaaaaaaaacfjdddiidjddhdiiiiidddjdddddjffjddddddddjfcaaaaaaaaaaa
aaaaaaaaaacfjdddiidjjjjjjjhhjjjjjdddddjffjjjjjjjjjjfcaaaaaaaaaaa
aaaaaaaaaacfjdddiidddddddjkkjdddddddddjffddddddddddfcaaaaaaaaaaa
aaaaaaaaaacfjdddiidddddddjddjdddddddddjffddddddddddfcaaaaaaaaaaa
aaaaaaaaaacfjdddiidddddddjddjdddddddddjffddddddddddfcaaaaaaaaaaa
aaaaaaaaaacfjddddddddddddjddjdddddddddjjfjjjjjjjjjjfcaaaaaaaaaaa
aaaaaaaaaacfjddddddddddddjkkjddddddddddjfjddddddddjfcaaaaaaaaaaa
aaaaaaaaaacfjjjjjjjjjjjjjjhhjjjjjjjjjjjjfjddddddddjfcaaaaaaaaaaa
aaaaaaaaaacffffffffffffffffffffffffffffffjddddddddjfcaaaaaaaaaaa
aaaaaaaaaacfjjjjjjjjfllllllffffffffffffffjddddddddjfcaaaaaaaaaaa
aaaaaaaaaacfjddddddjfkkkkkkfjjjjjjjjjjjjfjddddddddjfcaaaaaaaaaaa
aaaaaaaaaacfjddddddjfiiiiiifjddddddddddjfjddddddddjfcaaaaaaaaaaa
aaaaaaaaaacfjddddddjfddddddfjddddddddddjfjddddddddjfcaaaaaaaaaaa
aaaaaaaaaacfjddddddjfddddddfjddddddddddjfjdddddddjjfcaaaaaaaaaaa
aaaaaaaaaacfjddddddjfiiiiiifjdddjjjjjjjjfjdddddddjjfcaaaaaaaaaaa
aaaaaaaaaacfjjjdjjjjfkkkkkkfjdddjffffffffjddddddddjfcaaaaaaaaaaa
aaaaaaaaaacfffffffffffllllffjdddjffffffffjddddddddjfcaaaaaaaaaaa
aaaaaaaaaacfmmmmmmmmmfkkkkfjjdddjffjjjjjjjddddddddjfcaaaaaaaaaaa
aaaaaaaaaacfmbbeeebbmfiiiifjddddjffjddddddddddddddjfcaaaaaaaaaaa
aaaaaaaaaacfmbnnnnnbmfddddfjddddjffjddddddddddddddjfcaaaaaaaaaaa
aaaaaaaaaacfmennnnnemfddddfjddddjffjddddddddddddddjfcaaaaaaaaaaa
aaaaaaaaaacfmennnnnemfddddfjjjjjjffjddddddddddddddjfcaaaaaaaaaaa
aaaaaaaaaacfmennnnnemoggddfffffffffjddddddddddddddjfcaaaaaaaaaaa
aaaaaaaaaacfmbnnnnnbmoggddfffffffffjddddddddddddddjfcaaaaaaaaaaa
aaaaaaaaaacfmbbeeebbmoppiqfrfffffffjddddddddddddddjfcaaaaaaaaaaa
aaaaaaaaaacfmmmmmmmmmfkkkkfffffffffjjjjjjjjjjjjjjjjfcaaaaaaaaaaa
aaaaaaaaaacfffffffffffllllffffffffffffffffffffffffffcaaaaaaaaaaa
aaaaaaaaaabcccccccccccccccccccccccccccccccccccccccccbaaaaaaaaaaa
aaaaaaaaaaaaaaaaaaaaaaaaaaaaaaaaaaaaaaaaaaaaaaaaaaaaaaaaaaaaaaaa
aaaaaaaaaaaaaaaaaaaaaaaaaaaaaaaaaaaaaaaaaaaaaaaaaaaaaaaaaaaaaaaa
aaaaaaaaaaaaaaaaaaaaaaaaaaaaaaaaaaaaaaaaaaaaaaaaaaaaaaaaaaaaaaaa
aaaaaaaaaaaaaaaaaaaaaaaaaaaaaaaaaaaaaaaaaaaaaaaaaaaaaaaaaaaaaaaa
aaaaaaaaaaaaaaaaaaaaaaaaaaaaaaaaaaaaaaaaaaaaaaaaaaaaaaaaaaaaaaaa
aaaaaaaaaaaaaaaaaaaaaaaaaaaaaaaaaaaaaaaaaaaaaaaaaaaaaaaaaaaaaaaa
aaaaaaaaaaaaaaaaaaaaaaaaaaaaaaaaaaaaaaaaaaaaaaaaaaaaaaaaaaaaaaaa
aaaaaaaaaaaaaaaaaaaaaaaaaaaaaaaaaaaaaaaaaaaaaaaaaaaaaaaaaaaaaaaa
aaaaaaaaaaaaaaaaaaaaaaaaaaaaaaaaaaaaaaaaaaaaaaaaaaaaaaaaaaaaaaaa
aaaaaaaaaaaaaaaaaaaaaaaaaaaaaaaaaaaaaaaaaaaaaaaaaaaaaaaaaaaaaaaa
"}
