"a" = (/turf/simulated/ocean/abyss,/area/space/ocean)
"b" = (/turf/simulated/wall/r_wall,/area/cassini)
"c" = (/obj/effect/wingrille_spawn/reinforced/full,/turf/simulated/floor/plating,/area/cassini)
"d" = (/turf/simulated/floor/tiled,/area/cassini)
"e" = (/obj/effect/wingrille_spawn/reinforced_phoron/full,/turf/simulated/floor/plating,/area/cassini)
"f" = (/turf/simulated/floor/airless,/area/cassini)
"g" = (/obj/effect/landmark{name = "JoinLate"},/turf/simulated/floor/tiled,/area/cassini)
"h" = (/obj/effect/landmark/test/safe_turf,/turf/simulated/floor/tiled,/area/cassini)
"i" = (/obj/effect/landmark/start,/turf/simulated/floor/tiled,/area/cassini)

(1,1,1) = {"
aaaaaaaaaaaaaaaaaaaaaaaaaaaaaaaaaaaaaaaaaaaaaaaaaaaaaaaaaaaaaaaa
aaaaaaaaaaaaaaaaaaaaaaaaaaaaaaaaaaaaaaaaaaaaaaaaaaaaaaaaaaaaaaaa
aaaaaaaaaaaaaaaaaaaaaaaaaaaaaaaaaaaaaaaaaaaaaaaaaaaaaaaaaaaaaaaa
aaaaaaaaaaaaaaaaaaaaaaaaaaaaaaaaaaaaaaaaaaaaaaaaaaaaaaaaaaaaaaaa
aaaaaaaaaaaaaaaaaaaaaaaaaaaaaaaaaaaaaaaaaaaaaaaaaaaaaaaaaaaaaaaa
aaaaaaaaaaaaaaaaaaaaaaaaaaaaaaaaaaaaaaaaaaaaaaaaaaaaaaaaaaaaaaaa
aaaaaaaaaaaaaaaaaaaaaaaaaaaaaaaaaaaaaaaaaaaaaaaaaaaaaaaaaaaaaaaa
aaaaaaaaaaaaaaaaaaaaaaaaaaaaaaaaaaaaaaaaaaaaaaaaaaaaaaaaaaaaaaaa
aaaaaaaaaaaaaaaaaaaaaaaaaaaaaaaaaaaaaaaaaaaaaaaaaaaaaaaaaaaaaaaa
aaaaaaaaaaaaaaaaaaaaaaaaaaaaaaaaaaaaaaaaaaaaaaaaaaaaaaaaaaaaaaaa
aaaaaaaaaaaaaaaaaaaaaaaaaaaaaaaaaaaaaaaaaaaaaaaaaaaaaaaaaaaaaaaa
aaaaaaaaaabcccccccccccccccccccccccccccccccccccccccccbaaaaaaaaaaa
aaaaaaaaaacdddddddddddddddddddddddddddddddddddddddddcaaaaaaaaaaa
aaaaaaaaaacdddddddddddddddddddddddddddddddddddddddddcaaaaaaaaaaa
aaaaaaaaaacdddddddddddddddddddddddddddddddddddddddddcaaaaaaaaaaa
aaaaaaaaaacdddddddddddddddddddddddddddddddddddddddddcaaaaaaaaaaa
aaaaaaaaaacdddddddddddddddddddddddddddddddddddddddddcaaaaaaaaaaa
aaaaaaaaaacdddddddddddddddddddddddddddddddddddddddddcaaaaaaaaaaa
aaaaaaaaaacdddddddddddddddddddddddddddddddddddddddddcaaaaaaaaaaa
aaaaaaaaaacdddddddddddddddddddddddddddddddddddddddddcaaaaaaaaaaa
aaaaaaaaaacdddddddddddddddddddddddddddddddddddddddddcaaaaaaaaaaa
aaaaaaaaaacdddddddddddddddddddddddddddddddddddddddddcaaaaaaaaaaa
aaaaaaaaaacdddddddddddddddddddddddddddddddddddddddddcaaaaaaaaaaa
aaaaaaaaaacdddddddddddddddddddddddddddddddddddddddddcaaaaaaaaaaa
aaaaaaaaaacdddddddddddddddddddddddddddddddddddddddddcaaaaaaaaaaa
aaaaaaaaaacdddddddddddddddddddddddddddddddddddddddddcaaaaaaaaaaa
aaaaaaaaaacdddddddddddddddddddddddddddddddddddddddddcaaaaaaaaaaa
aaaaaaaaaacdddddddddddddddddddddddddddddddddddddddddcaaaaaaaaaaa
aaaaaaaaaacdddddddddddddddddddddddddddddddddddddddddcaaaaaaaaaaa
aaaaaaaaaacdddddddddddddddddddddddddddddddddddddddddcaaaaaaaaaaa
aaaaaaaaaacdddddddddddddddddddddddddddddddddddddddddcaaaaaaaaaaa
aaaaaaaaaacdddddddddddddddddddddddddddddddddddddddddcaaaaaaaaaaa
aaaaaaaaaacdddddddddddddddddddddddddddddddddddddddddcaaaaaaaaaaa
aaaaaaaaaacdddddddddddddddddddddddddddddddddddddddddcaaaaaaaaaaa
aaaaaaaaaacdddddddddddddddddddddddddddddddddddddddddcaaaaaaaaaaa
aaaaaaaaaacdddddddddddddddddddddddddddddddddddddddddcaaaaaaaaaaa
aaaaaaaaaacdddddddddddddddddddddddddddddddddddddddddcaaaaaaaaaaa
aaaaaaaaaacdddddddddddddddddddddddddddddddddddddddddcaaaaaaaaaaa
aaaaaaaaaacdddddddddddddddddddddddddddddddddddddddddcaaaaaaaaaaa
aaaaaaaaaacdddddddddddddddddddddddddddddddddddddddddcaaaaaaaaaaa
aaaaaaaaaacdddddddddddddddddddddddddddddddddddddddddcaaaaaaaaaaa
aaaaaaaaaacdddddddddddddddddddddddddddddddddddddddddcaaaaaaaaaaa
aaaaaaaaaacdddddddddddddddddddddddddddddddddddddddddcaaaaaaaaaaa
aaaaaaaaaacdddddddddddddddddddddddddddddddddddddddddcaaaaaaaaaaa
aaaaaaaaaacddbbeeebbddddddddddddddddddddddddddddddddcaaaaaaaaaaa
aaaaaaaaaacddbfffffbddddddddddddddddddddddddddddddddcaaaaaaaaaaa
aaaaaaaaaacddefffffeddddddddddddddddddddddddddddddddcaaaaaaaaaaa
aaaaaaaaaacddefffffeddddddddddddddddddddddddddddddddcaaaaaaaaaaa
aaaaaaaaaacddefffffedgggddddddddddddddddddddddddddddcaaaaaaaaaaa
aaaaaaaaaacddbfffffbdgggddddddddddddddddddddddddddddcaaaaaaaaaaa
aaaaaaaaaacddbbeeebbdgggdhdiddddddddddddddddddddddddcaaaaaaaaaaa
aaaaaaaaaacdddddddddddddddddddddddddddddddddddddddddcaaaaaaaaaaa
aaaaaaaaaacdddddddddddddddddddddddddddddddddddddddddcaaaaaaaaaaa
aaaaaaaaaabcccccccccccccccccccccccccccccccccccccccccbaaaaaaaaaaa
aaaaaaaaaaaaaaaaaaaaaaaaaaaaaaaaaaaaaaaaaaaaaaaaaaaaaaaaaaaaaaaa
aaaaaaaaaaaaaaaaaaaaaaaaaaaaaaaaaaaaaaaaaaaaaaaaaaaaaaaaaaaaaaaa
aaaaaaaaaaaaaaaaaaaaaaaaaaaaaaaaaaaaaaaaaaaaaaaaaaaaaaaaaaaaaaaa
aaaaaaaaaaaaaaaaaaaaaaaaaaaaaaaaaaaaaaaaaaaaaaaaaaaaaaaaaaaaaaaa
aaaaaaaaaaaaaaaaaaaaaaaaaaaaaaaaaaaaaaaaaaaaaaaaaaaaaaaaaaaaaaaa
aaaaaaaaaaaaaaaaaaaaaaaaaaaaaaaaaaaaaaaaaaaaaaaaaaaaaaaaaaaaaaaa
aaaaaaaaaaaaaaaaaaaaaaaaaaaaaaaaaaaaaaaaaaaaaaaaaaaaaaaaaaaaaaaa
aaaaaaaaaaaaaaaaaaaaaaaaaaaaaaaaaaaaaaaaaaaaaaaaaaaaaaaaaaaaaaaa
aaaaaaaaaaaaaaaaaaaaaaaaaaaaaaaaaaaaaaaaaaaaaaaaaaaaaaaaaaaaaaaa
aaaaaaaaaaaaaaaaaaaaaaaaaaaaaaaaaaaaaaaaaaaaaaaaaaaaaaaaaaaaaaaa
"}
