"a" = (/turf/space,/area/europa/ocean)
"b" = (/turf/simulated/wall,/area/europa/ocean)
"c" = (/turf/simulated/floor/tiled,/area/arrival/start)
"d" = (/turf/simulated/floor/tiled,/area/europa/ocean)

(1,1,1) = {"
aaaaaaaaaaaaaaaaaaaaaaaaaaaaaa
aaaaaaaaaaaaaaaaaaaaaaaaaaaaaa
aaaaaaaaaaaaaaaaaaaaaaaaaaaaaa
aaaaaaaaaaaaaaaaaaaaaaaaaaaaaa
aaaaaaaaaaaaaaaaaaaaaaaaaaaaaa
aaaaaaaaaaaaaaaaaaaaaaaaaaaaaa
aaaaaaaaaaaaaaaaaaaaaaaaaaaaaa
aaaaaaabbbbbbbbbbbbbbbbaaaaaaa
aaaaaaabcccdddddddddddbaaaaaaa
aaaaaaabcccdddddddddddbaaaaaaa
aaaaaaabcccdddddddddddbaaaaaaa
aaaaaaabddddddddddddddbaaaaaaa
aaaaaaabddddddddddddddbaaaaaaa
aaaaaaabddddddddddddddbaaaaaaa
aaaaaaabddddddddddddddbaaaaaaa
aaaaaaabddddddddddddddbaaaaaaa
aaaaaaabddddddddddddddbaaaaaaa
aaaaaaabddddddddddddddbaaaaaaa
aaaaaaabddddddddddddddbaaaaaaa
aaaaaaabddddddddddddddbaaaaaaa
aaaaaaabddddddddddddddbaaaaaaa
aaaaaaabddddddddddddddbaaaaaaa
aaaaaaabbbbbbbbbbbbbbbbaaaaaaa
aaaaaaaaaaaaaaaaaaaaaaaaaaaaaa
aaaaaaaaaaaaaaaaaaaaaaaaaaaaaa
aaaaaaaaaaaaaaaaaaaaaaaaaaaaaa
aaaaaaaaaaaaaaaaaaaaaaaaaaaaaa
aaaaaaaaaaaaaaaaaaaaaaaaaaaaaa
aaaaaaaaaaaaaaaaaaaaaaaaaaaaaa
aaaaaaaaaaaaaaaaaaaaaaaaaaaaaa
"}
