"a" = (/turf/simulated/ocean,/area/europa/ocean)
"b" = (/turf/simulated/wall,/area/centcom)
"c" = (/obj/effect/wingrille_spawn/reinforced,/turf/simulated/floor,/area/centcom)
"d" = (/turf/simulated/floor/tiled,/area/centcom)
"e" = (/turf/simulated/floor/tiled,/area/arrival)
"f" = (/obj/machinery/light/small{dir = 4; pixel_y = 0},/turf/simulated/floor/tiled,/area/centcom)
"g" = (/obj/machinery/light/small{dir = 8},/turf/simulated/floor/tiled,/area/centcom)
"h" = (/obj/machinery/power/debug_items/infinite_generator,/turf/simulated/floor/tiled,/area/centcom)
"i" = (/obj/effect/landmark{name = "Observer-Start"},/turf/simulated/floor/tiled,/area/arrival)
"j" = (/obj/effect/landmark/start,/turf/simulated/floor/tiled,/area/arrival)
"k" = (/obj/machinery/light/small{dir = 1},/turf/simulated/floor/tiled,/area/centcom)
"l" = (/obj/machinery/power/apc/east,/turf/simulated/floor/tiled,/area/centcom)
"m" = (/obj/machinery/light/small,/turf/simulated/floor/tiled,/area/centcom)
"n" = (/obj/effect/landmark{name = "JoinLate"},/turf/simulated/floor/tiled,/area/centcom)
"o" = (/obj/effect/landmark/start/crewman,/turf/simulated/floor/tiled,/area/centcom)

(1,1,1) = {"
aaaaaaaaaaaaaaaaaaaaaaaaaaaaaa
aaaaaaaaaaaaaaaaaaaaaaaaaaaaaa
aaaaaaaaaaaaaaaaaaaaaaaaaaaaaa
aaaaaaaaaaaaaaaaaaaaaaaaaaaaaa
aaaaaaaaaaaaaaaaaaaaaaaaaaaaaa
aaaaaaaaaaaaaaaaaaaaaaaaaaaaaa
aaaaaaaaaaaaaaaaaaaaaaaaaaaaaa
aaaaaaabbccbbaaaabbccbbaaaaaaa
aaaaaaabeeedbaaaabdddhbaaaaaaa
aaaaaaacejifbbccbbgdddcaaaaaaa
aaaaaaaceeeddddddddddlcaaaaaaa
aaaaaaabdddddmddmdddddbaaaaaaa
aaaaaaabbbddbbccbbddbbbaaaaaaa
aaaaaaaaabdfbaaaabgdbaaaaaaaaa
aaaaaaaaacddcaaaacddcaaaaaaaaa
aaaaaaaaacddcaaaacddcaaaaaaaaa
aaaaaaaaabdfbaaaabgdbaaaaaaaaa
aaaaaaabbbddbbccbbddbbbaaaaaaa
aaaaaaabdddddkddkdddddbaaaaaaa
aaaaaaacddddddddddddddcaaaaaaa
aaaaaaacdonfbbccbbgdddcaaaaaaa
aaaaaaabddddbaaaabddddbaaaaaaa
aaaaaaabbccbbaaaabbccbbaaaaaaa
aaaaaaaaaaaaaaaaaaaaaaaaaaaaaa
aaaaaaaaaaaaaaaaaaaaaaaaaaaaaa
aaaaaaaaaaaaaaaaaaaaaaaaaaaaaa
aaaaaaaaaaaaaaaaaaaaaaaaaaaaaa
aaaaaaaaaaaaaaaaaaaaaaaaaaaaaa
aaaaaaaaaaaaaaaaaaaaaaaaaaaaaa
aaaaaaaaaaaaaaaaaaaaaaaaaaaaaa
"}

